kya - きゃ
kyu - きゅ
kyo - きょ
gya - ぎゃ
gyu - ぎゅ
gyo - ぎょ
sha - しゃ
shu - しゅ
sho - しょ
ja - じゃ
ju - じゅ
jo - じょ
cha - ちゃ
chu - ちゅ
cho - ちょ
nya - にゃ
nyu - にゅ
nyo - にょ
hya - ひゃ
hyu - ひゅ
hyo - ひょ
bya - びゃ
byu - びゅ
byo - びょ
pya - ぴゃ
pyu - ぴゅ
pyo - ぴょ
mya - みゃ
myu - みゅ
myo - みょ
rya - りゃ
ryu - りゅ
ryo - りょ
chi - ち
tsu - つ
shi - し
dzu - づ
ka - か
ki - き
ku - く
ke - け
ko - こ
sa - さ
su - す
se - せ
so - そ
ta - た
te - て
to - と
na - な
ni - に
nu - ぬ
ne - ね
no - の
ha - は
hi - ひ
fu - ふ
he - へ
ho - ほ
ma - ま
mi - み
mu - む
me - め
mo - も
ya - や
yu - ゆ
yo - よ
ra - ら
ri - り
ru - る
re - れ
ro - ろ
wa - わ
wo - を
n - ん
ga - が
gi - ぎ
gu - ぐ
ge - げ
go - ご
za - ざ
ji - じ
zu - ず
ze - ぜ
zo - ぞ
da - だ
di - ぢ
du - づ
de - で
do - ど
ba - ば
bi - び
bu - ぶ
be - べ
bo - ぼ
pa - ぱ
pi - ぴ
pu - ぷ
pe - ぺ
po - ぽ
a - あ
i - い
u - う
e - え
o - お