がくせい - gakusei - estudiante, alumno - hiragana
にほんじん - nihonjin - persona japonesa, el pueblo japonés, Japonés, Japonesa - hiragana
アメリカじん - amerikajin - Estadounidense - katakana
あなた - anata - tú (tradicionalmente, forma cortés de referirse a alguien de estatus igual o inferior, ahora a menudo considerado grosero o distante); {fam} querido, cariño (usado por las esposas dirigiéndose a sus maridos) - hiragana
いしゃ - isha - doctor, médico, facultativo - hiragana
いそがしい - isogashii - ocupado, irritado - hiragana
くるま - kuruma - automóvil, coche, vehículo, (am) carro; rueda - hiragana
たかい - takai - alto, elevado; caro - hiragana
えんぴつ - enpitsu - lápiz - hiragana
やすい - yasui - barato; calma, pacífico, quieto, barato - hiragana
すし - sushi - sushi, sushi, cualquier cosa con arroz en vinagre (que también lleva vegetales, especias, pescado, etc), "sushi": arroz avinagrado con pescado crudo - hiragana
おいしい - oishii - delicioso, sabroso, rico - hiragana
きょう - kyou - hoy, este día - hiragana
あつい - atsui - caliente, cálido (clima) - hiragana
あした - ashita - mañana - hiragana
どようび - doyoubi - sábado - hiragana
しけん - shiken - examen, prueba, estudio - hiragana
むずかしい - muzukashii - difícil, complicado, complejo, serio (enfermedad, problema, etc.); {euph} imposible, inviable; quisquilloso, particular, fastidioso, difícil de satisfacer, descontento; sombrío, taciturno, silencioso, serio (apariencia); {arch} sucio, contaminado, asqueroso, detestable; {arch} desagrable, molesto, espeluznante, que da miedo - hiragana
しんせつ - shinsetsu - amable - hiragana
げんき - genki - salud, saludable, vigor, energía, vitalidad, brío, aguante, coraje, ánimo, empuje - hiragana
ひま - hima - tiempo libre - hiragana
かいしゃいん - kaishain - empleado (en una empresa comercial) - hiragana
ハンサム - hansemu - (eng: handsome) guapo, galán - katakana
ここ - koko - aquí, este lugar, aquí, este sitio, este lugar - hiragana
ゆうめい - yuumei - famoso; fama - hiragana
これ - kore - esto, éste, ésta, éstos, éstas; esta persona; ahora; aquí; yo (mi); claramente, por supuesto; esto, éste, ésta; esta persona; ahora; aquí; yo (mi); seguramente; esto, éste, ésta; esta persona (usu. indicando a alguien del grupo); ahora; aquí; Yo (mi); claramente, por supuesto - hiragana
ペン - pen - bolígrafo, pluma; PEN (club) - katakana
へや - heya - habitación - hiragana
にちようび - nichiyoubi - domingo - hiragana
こいびと - koibito - amante - hiragana
だいがく - daigaku - universidad - hiragana
せんせい - sensei - maestro, profesor, doctor - hiragana
カメラ - kamera - cámara (fotos, video) (eng: camera) - katakana
ざっし - zasshi - revista - hiragana
それ - sore - eso, ello, ése, ésa - hiragana
ほん - hon - libro, volumen; principal, verdad, real; contador para objetos cilindricos largos - hiragana
あれ - are - aquello, aquél, aquella - hiragana
にほんご - nihongo - japonés (idioma) - hiragana
じしょ - jisho - diccionario, léxico - hiragana
ともだち - tomodachi - amigo, compañero - hiragana
かばん - kaban - mochila, cartapacio, portafolio, cesta, canasta, bolsa, morral, cartera - hiragana
にほん - nihon - Japón - hiragana
いえ - ie - casa; familia; linaje, apellido - hiragana
おおきい - ookii - grande, largo - hiragana
せまい - semai - estrecho - hiragana
りょうり - ryouri - cocina, arte culinario - hiragana
ちゅうごくじん - chuugokujin - chino (persona) - hiragana
おかあさん - okaasan - madre - hiragana
かいしゃ - kaisha - empresa, compañía, corporación - hiragana
おかし - okashi - dulces, golosinas, caramelos, confituras, dulces, golosinas, confituras - hiragana
やさしい - yasashii - tierno, bueno, gentil, agraciado, afectuoso, amable, afable - hiragana
はは - haha - {hum} madre - hiragana
うつくしい - utsukushii - hermoso, bello - hiragana
ひと - hito - persona, (sp) las personas - hiragana
コーヒー - koohii - café (bebida), café (eng: coffee, dut: koffie) - katakana
あかるい - akarui - claro, luminoso, brillante, alegre, abierto, risueño, jovial, ser un entendido en.., saber (algo) al dedillo de… - hiragana
てんいん - tenin - dependiente, vendedor de una tienda, empleado - hiragana
やきゅう - yakyuu - béisbol - hiragana
たのしい - tanoshii - divertido - hiragana
スポツ - supootsu - deporte (eng: sport) - katakana
そこ - soko - ahí, ese lugar - hiragana
ひろい - hiroi - espacioso, vasto, amplio - hiragana
みせ - mise - tienda, comercio, establecimiento - hiragana
ビル - biru - edificio (eng: building); factura (eng: bill) - katakana
いい - ii - bueno, placentero, fino, excelente, agradable, está bien, bueno, justo, correcto, honrado, bueno, bello, espléndido, excelente, bueno, placentero, fino, excelente, agradable, está bien; suficiente (puede usarse para negar un ofrecimiento), listo, preparado, provechoso (negocios, etc), beneficioso; Está bien - hiragana
てんき - tenki - clima, los elementos - hiragana
にもつ - nimotsu - equipaje - hiragana
かるい - karui - liviano, sensación de ligereza (es decir, que ofrece poca resistencia, que se mueve con facilidad); ligero (de pie), sin esfuerzo, ágil; no serio, menor, sin importancia, trivial; leve, pequeño, suave, blando, fácil, ligero (broma); fácil, sencillo; indiscriminado - hiragana
スーツケース - suutsukeesu - (eng: suitcase) maleta - katakana
ねこ - neko - gato (esp. el gato doméstico, Felis catus); samisén; geisha; {abbr} carretilla; {abbr} calentador de cama de arcilla; {sl} pasivo (parte sumisa de una relación homosexual) - hiragana
かわいい - kawaii - bonito, hermoso, preferido, querido, amado, encantador; precioso, fascinante, seductor, amado, querido, gracioso, favorito, especial; bonito, hermoso, lindo, mono, atractivo, encantador; precioso, fascinante, seductor, amado, querido, gracioso, favorito, especial - hiragana
どうぶつ - doubutsu - animal - hiragana
ちち - chichi - padre - hiragana
かしゅ - kasha - cantante - hiragana
まじめ - majime - diligente, serio, honesto - hiragana
たいせつ - taisetsu - importante, valioso, digno de cuidado - hiragana
かんたん - kantan - simple, sencillo - hiragana
もんだい - mondai - problema, pregunta - hiragana
あんぜん - anzen - seguro; seguridad - hiragana
くに - kuni - país - hiragana
すてき - suteki - encantador, maravilloso, espléndido - hiragana
こうえん - kouen - parque (público) - hiragana
スーパー - suupaa - (eng: super) super ~, supermercado - katakana
べんり - benri - conveniente, útil - hiragana
そと - soto - afuera, exterior; al aire libre; otro lugar - hiragana
くらい - kurai - sombrío, oscuro, falto de luz, oscuro, tenebroso; gris; deprimido, desalentado; pesaroso, amargo (como una pasado oscuro); no claro, no familiar, desconocido, sombrío, oscuro, falto de sol; oscuro, obscuro, tenebroso; deprimido, desalentado; pena, amargo (como un pasado negro); no claro, desconocido - hiragana
まんが - manga - comic, historieta, caricatura - hiragana
おもしろい - omoshiroi - interesante, entretenido - hiragana
おんがく - ongaku - música, movimiento musical - hiragana
ふゆ - fuyu - invierno - hiragana
さむい - samui - frío (ej. clima) - hiragana
うみ - umi - mar, playa - hiragana
アイス - aisu - hielo (Ing: Ice, Ale: Eis); helado, mantecado - katakana
つめたい - tsumetai - frío (al tacto), gélido, helado, congelado; (emocionalmente) frío, insensible, indiferente, antipático, distante - hiragana
あかちゃん - akachan - bebe, criatura, nene, nena - hiragana
かっこいい - kakkoii - atractivo, guapo, elegante - hiragana
べんきょう - benkyou - estudio; diligencia; descuento, reducción - hiragana
ねむい - nemui - soñoliento, amodorrado - hiragana
しんぱい - shinpai - preocupación, preocupar - hiragana
ふくざつ - fukuzatsu - complejidad, complicación - hiragana
クリスマス - kurisumasu - Navidad (eng: Christmas) - katakana
にぎやか - nigiyaka - tumultuoso, ocupado - hiragana
だめ - dame - inútil, no bueno, sin esperanza - hiragana
しごと - shigoto - trabajo, empleo, ocupación - hiragana
えき - eki - estación (ej. autobuses) - hiragana
ばか - baka - tonto, estúpido, bobo, idiota, tonto, idiota - hiragana
らく - raku - comodidad, confort, alivio, (en) paz, relajación; {adj-na} {n} fácil, sencillo, sin problemas, sin dificultades; {adj-na} {n} (económicamente) cómodo; {abbr} cerámica raku; {Buddh} sukha (felicidad) - hiragana
けち - kechi - avaricia, tacañería, mezquindad, avaro, tacaño, miserable; {adj-na} {n} cutre, barato, pobre, mísero; mezquino, estrecho de miras, de mente pequeña; mala suerte, mal agüero, infortunio, maldición - hiragana
ひ - hi - día; sol - hiragana
しずか - shizuka - callado, silencioso; lento, sin prisas; tranquilo, sereno, calmado - hiragana
まち - machi - pueblo; calle, camino, calles principales, avenidas, calles céntricas, zona comercial, barrio comercial, barrio animado y bullicioso - hiragana
わたしたち - watashitachi - nosotros, (pn) nosotros, nosotros, nosotros, nos - hiragana
なかがいい - nakagaii - próximo, íntimo, en buenos términos, tener buena relación con, llevarse bien con - hiragana
パン - pan - (pt) pan - katakana
やわらかい - yawarakai - blando, tierno, flexible, maleable, flojo; apacible, suave, tranquilo; liviano (tema, libro, etc.), informal; flexible (pensamiento, mente, etc.), maleable, adaptable - hiragana
わかい - wakai - joven - hiragana
おちゃ - ocha - té (verde) - hiragana
あまい - amai - dulce, dulzón, suave, indulgente, azucarado, soso, poco salado, indulgente, tolerante, poco severo, optimismo - hiragana
かみ - kami - pelo (de la cabeza), cabello - hiragana
ながい - nagai - largo, mucho tiempo, largo, prolongado - hiragana
わるい - warui - malo, pobre, inferior; pecador; no rentable, sin beneficio; falla, culpa, tener la culpa; perdón - hiragana
パソコン - pasokon - ordenador (personal), computadora - katakana
あたらしい - atarashii - nuevo - hiragana
こわい - kowai - asustadizo, temeroso, espeluznante, espantoso, asustadizo, temeroso, espeluznante, espantoso; Tengo Miedo - hiragana
えいが - eiga - cine, película, film - hiragana
うれしい - ureshii - feliz, alegre, agradable - hiragana
はなし - hanashi - habla, plática, conversación, charla, relato - hiragana
きびしい - kibishii - severo, estricto, rígido, implacable; difícil (de hacer), dificultoso, complicado; intenso (por ej. frío), severo (clima), inclemente - hiragana
よわい - yowai - débil, endeble, delicado, tierno, inexperto, suave (ej. vino) - hiragana
サラダ - sarada - ensalada (por: salad) - katakana
あつい - atsui - caliente (cosas) - hiragana
たべもの - tabemono - comida - hiragana
おおい - ooi - muchos, numeroso - hiragana
おもい - omoi - pesado; grave, serio - hiragana
むすめ - musume - (mi) hija; chica (i.e. una mujer joven y sin casar) - hiragana
せがたかい - segatakai - alto de estatura - hiragana
つよい - tsuyoi - fuerte, poderoso, potente, vigoroso, enérgico, valiente, intrépido, robusto - hiragana
おとこ - otoko - hombre, varón - hiragana
つまらない - tsumaranai - aburrido, poco interesante, tedioso; insignificante, sin importancia, trivial, sin valor; absurdo, tonto, estúpido; inútil, sin sentido, decepcionante - hiragana
ふかい - fukai - profundo - hiragana
かわ - kawa - río, arroyo, riachuelo; {suf} Río, el río ... (sufijo utilizado con los nombres de ríos) - hiragana
あたまがいい - atamagaii - inteligente, brillante - hiragana
かなしい - kanashii - triste, tristeza, dolor, duelo, pena, congoja - hiragana
さびしい - sabishii - solo, solitario, aislado, apartado, desolado - hiragana
ただしい - tadashii - correcto, justo, derecho - hiragana
がっこう - gakkou - escuela - hiragana
こ - ko - hijo, hija, niño, niña, chico, chica, niño; joven (animal); mujer joven, geisha joven; retoño; interés; acciones nuevas (bolsa); huevo de ave - hiragana
じょうず  - jouzu - habilidoso, hábil, competente, bueno (en), diestro, inteligente; {n} adulación, halago - hiragana
え - e - pintura, dibujo, ilustración, cuadro, pintura - hiragana
パスタ - pasuta - pasta (ita:) - katakana
よる - yoru - noche; cena - hiragana
むすこ - musuko - hijo (varón) - hiragana
みず - mizu - agua (fría, fresca) - hiragana
あおい - aoi - azul, verde; pálido; inmaduro, sin experiencia; azul, verde - hiragana
たいへん - taihen - muy; inmenso, enorme, grande; serio, grave, espantoso, terrible; difícil, duro; incidente mayor, desatre - hiragana
ちかい - chikai - cerca - hiragana
こども - kodomo - niño, niños - hiragana
すき - suki - gustar, gustado - hiragana
はな - hana - flor, flor, pétalo - hiragana
さかな - sakana - pez, pez, pescado - hiragana
ネクタイ - nekutai - corbata (eng: necktie) - katakana
きらい - kirai - disgusto, odio; sospecha, tendencia, indicio - hiragana
カラオケ - karaoke - karaoke (cantar música grabada) - katakana
おさけ - osake - sake - hiragana
びょういん - byouin - hospital - hiragana
ゴルフ - gorufu - golf (eng:) - katakana
きもの - kimono - kimono, vestimenta tradicional japonesa (espec. de cuerpo entero); ropa, prendas de vestir - hiragana
えいご - eigo - Idioma Inglés, lengua inglesa - hiragana
めがね - megane - gafas, (am) lentes, (am) anteojos - hiragana
ほしい - hoshii - deseado, deseado por, necesidad de; (después de la forma -te de un verbo) quiero que (tu)... - hiragana
イヤリング - iyaringu - pendiente (eng: earring) - katakana
ジュース - juusu - (eng: juice) jugo (eng: zumo) - katakana
じてんしゃ - jitensha - bicicleta - hiragana
エアコン - eakon - aire acondicionado - katakana
シャーペン - shaapen - portaminas - katakana
ビール - biiru - cerveza (dut: bier) - katakana
ごはん - gohan - arroz (cocinado), platillo, comida, comida (lit arroz)  - hiragana
ピアノ - piano - piano (eng:) - katakana
コート - kooto - (eng: coat, court) abrigo, campo deportivo - katakana
しゅふ - shufu - ama de casa, señora - hiragana
あさごはん - asagohan - desayuno - hiragana
しろい - shiroi - blanco - hiragana
タイ - tai - corbata, Tai, Tailandia - katakana
のみもの - nomimono - bebida - hiragana
おべんとう - obentou - o-bento, almuerzo portátil, (am) itacate - hiragana
あたたかい - atatakai - cálido, afable, cordial, apacible, suave, templado - hiragana
おにぎり - onigiri - bola de arroz (a menudo triangular, a veces con un relleno y envuelto en nori) - hiragana
おねえさん - oneechan - hermana mayor; (vocativo) jovencita; señora (a las camareras); madre (usado por las geishas para referirse a sus superioras), hermana mayor, (vocativo) ¿Señora? - hiragana
ばんごはん - bangohan - cena - hiragana
すきやき - sukiyaki - guiso tradicional a base de carne y verduras - hiragana
ですか - desuka - Indica pregunta - hiragana
ジャケット - jaketto - chaqueta; cubierta de libro, sobrecubierta; carátula de CD, carátula de disco de vinilo - katakana
くろい - kuroi - negro; oscuro, obscuro - hiragana
いろ - iro - color; sensualidad, placeres amorosos, lujuria - hiragana
ぎんこういん - ginkouin - empleado de banca, banquero - hiragana
てんぷら - tenpura - "tempura": fritura de mariscos y vegetales rebozados - hiragana
ことし - kotoshi - este año - hiragana
なん - nan - qué - hiragana
ワイン - wain - vino (eng: wine) - katakana
ばしょ - basho - lugar, ubicación - hiragana
ゆうびんきょく - yuubinkyoku - oficina postal, oficina de correos - hiragana
おおきな - ookina - grande, gran, largo - hiragana
ケーキや - keekiya - Pastelería - hiragana
どこ - goto - dónde, en que lugar, donde, dónde, qué lugar, dónde, en que lugar - hiragana
おとうさん - otousan - padre - hiragana
だれ - dare - quién - hiragana
じょせい - josei - sexo femenino, mujer (mejor término que onna); género femenino - hiragana
せのたかい - senotakai - Alto (de una persona) - hiragana
だんせい - dansei - sexo masculino, hombre - hiragana
おにいさん - oniichan - hermano mayor, (vocativo) joven, chico, hermano mayor, (vocativo) ¿Señor? - hiragana
どんな - donna - como qué, qué tipo de - hiragana
もくようび - mokuyoubi - jueves - hiragana
げつようび - getsuyoubi - lunes - hiragana
すいようび - suiyoubi - miércoles - hiragana