たいいくかん - taiikukan - gimnasio
れんしゅうする - ranshuusuru - practicar
ぎんこう - ginkou - banco
つとめる - tsutomeru - desempeñar, ejercer, hacerse cargo de, trabajar, servir, estar empleado
レストラン - resutoran - restaurante
たべる - taberu - comer
きっさてん - kissaten - cafetería
どうぶつえん - doubutsuen - zoológico
かれら - karera - ellos
プール - puuru - piscina
ごじ - goji - Cinco en punto (hora)
おきる - okiru - levantarse, despertarse; suceder, tener lugar
はちじ - hachiji - Ocho en punto (hora)
ねる - neru - acostarse, dormir
しちじ - shichiji - 7 en punto (hora)
でかける - dekakeru - partir, salir fuera, ponerse en marcha
じゅうにじ - juuniji - doce en punto (hora)
つく - tsuku - llegar a, alcanzar; formar parte de, sentarse a
じゅういちじ - juuichiji - once en punto
こどもたち - kodomotachi - niños (grupo)
ろくじ - rokuji - 6 en punto (hora)
おなかがすく - onakagasuku - tener hambre
しがつ - shigatsu - abril
はじまる - hajimaru - comenzar
としょかん - toshokan - biblioteca
ひらく - hiraku - abrirse, quedarse abierto, quedarse vacío
じゅうにがつ - juunigatsu - diciembre
しちがつ - shichigatsu - julio
おくる  - okuru - enviar (cosas), despachar, escoltar, acompañar, despedirse
コンサート - konsaato - concierto
ふく - fuku - ropa (esp. ropa occidental); contador para dosis (medicina, tragos, caladas...)
つくる - tsukuru - hacer, crear, fabricar, manufacturar, etc...
うる - uru - vender
まんねんひつ - mannenhitsu - pluma estilográfica
つかう - tsukau - despachar, enviar, donar, usar, manipular, emplear, necesitar, querer...
さしみ - sashimi - Sashimi (Pescado cortado en rajas)
ダンス - dansu - danza
おどる - odoru -bailar, danzar; saltar
いけばな - Ikebana - Ikebana (arte de arreglo floral)
ノート - nooto - libreta, cuaderno
みせる - miseru - mostrar
おさら - osara - plato, platillo
あらう - arau - lavar
しゃしん - shashin - fotografía
とる - toru - grabar (vídeo, audio, etc.), tomar (foto), hacer (película)
そふ - sofu - abuelo (propio)
タバコ - tabako - tabaco, cigarrillos, puros; planta de tabaco
すう - suu - fumar, aspirar, inhalar; chupar, sorber; absorber, embeber; besar
しんぶん - sinbun - periódico
アパート - apaato - apartamento, bloque de apartamentos
かりる - kariru - tomar prestado, rentar, alquilar
きる - kiru - vestir, ponerse, llevar puesto; cargar con (culpa, etc.)
そぼ - sobo - abuela
アメリカ - amerika - América
くうこう - kuukou - aeropuerto
いく - iku - ir, moverse (hacia), dirigirse (hacia); atravesar, pasar por
がいこく - gaikoku - país extranjero
おんせん - onsen - aguas termales, balneario, spa
けっこんしき - kekkonshiki - ceremonia de matrimonio, boda
たいしかん - taishikan - embajada
デパート - depaato - centro comercial, grandes almacenes
かぞく - kazoku - familia, familiares
イギリス - igirisu - Gran Bretaña, Reino Unido
りょかん - ryokan - hostal (estilo japonés)
ホテル - hoteru - hotel
いなか - inaka - rural, el campo, suburbio; ciudad de origen o residencia
やすむ - yasumu - descansar, tener un respiro, tomarse el día
すわる - suwaru - sentarse, ponerse en cuclillas; asumir posición
せいと - seito - alumno (generalmente de primaria/instituto)
フランスご - furansugo -  francés (idioma)
ようふく - youfuku - ropa estilo occidental
クラブ - kurabu - club, sede de un club
てつだう - tetsudau - ayudar, tomar parte en
あるく - aruku - caminar
たまご - tamago - huevo; experto en preparación, futuro experto
やま - yama - montaña; montón; climax
あさ - asa - mañana (momento del día); desayuno
でんしゃ - densha - tren eléctrico
のる - noru - subirse, entrar (a vehículo); extender (pantalones)
ひこうき - hikouki - avión
わらう - warau - reír, sonreír; burlarse de
チョコレート - chokoreeto - chocolate
やさい - yasau - verdura
サッカー - sakkaa - fútbol
ぎゅうにゅう - gyuunyuu - leche de vaca