がくせい - gakusei - estudiante, alumno - hiragana
にほんじん - nihonjin - persona japonesa - hiragana
アメリカじん - amerikajin - estadounidense - katakana
あなた - anata - tú (informal), querido, cariño - hiragana
いしゃ - isha - doctor, médico - hiragana
いそがしい - isogashii - ocupado, irritado - hiragana
くるま - kuruma - coche, vehículo - hiragana
たかい - takai - elevado, caro - hiragana
えんぴつ - enpitsu - lápiz - hiragana
やすい - yasui - barato, pacífico - hiragana
すし - sushi - arroz avinagrado con pescado crudo - hiragana
おいしい - oishii - delicioso, sabroso - hiragana
きょう - kyou - hoy - hiragana
あつい - atsui - caliente, cálido (clima) - hiragana
あした - ashita - mañana - hiragana
どようび - doyoubi - sábado - hiragana
しけん - shiken - examen, prueba - hiragana
むずかしい - muzukashii - difícil, complicado, complejo - hiragana
しんせつ - shinsetsu - amable - hiragana
げんき - genki - salud, saludable, vigor - hiragana
ひま - hima - tiempo libre - hiragana
かいしゃいん - kaishain - empleado (corporativo) - hiragana
ハンサム - hansemu - guapo (anglicismo), galán - katakana
ここ - koko - aquí, este lugar - hiragana
ゆうめい - yuumei - famoso, fama - hiragana
これ - kore - esto, éste, por supuesto - hiragana
ペン - pen - bolígrafo (anglicismo), pluma - katakana
へや - heya - habitación - hiragana
にちようび - nichiyoubi - domingo - hiragana
こいびと - koibito - amante - hiragana
だいがく - daigaku - universidad - hiragana
せんせい - sensei - maestro, profesor, doctor - hiragana
カメラ - kamera - cámara (anglicismo) - katakana
ざっし - zasshi - revista - hiragana
それ - sore - eso, ése, ésa - hiragana
ほん - hon - libro, verdad, contador para objetos cilindricos largos - hiragana
あれ - are - aquello, aquél, aquella - hiragana
にほんご - nihongo - japonés (idioma) - hiragana
じしょ - jisho - diccionario, léxico - hiragana
ともだち - tomodachi - amigo, compañero - hiragana
かばん - kaban - mochila, bolsa, cartera - hiragana
にほん - nihon - Japón - hiragana
いえ - ie - casa, familia, linaje - hiragana
おおきい - ookii - grande, largo - hiragana
せまい - semai - estrecho - hiragana
りょうり - ryouri - cocina, arte culinario - hiragana
ちゅうごくじん - chuugokujin - chino (persona) - hiragana
おかあさん - okaasan - madre - hiragana
かいしゃ - kaisha - empresa, compañía, corporación - hiragana
おかし - okashi - dulces, golosinas - hiragana
やさしい - yasashii - tierno, bueno, gentil - hiragana
はは - haha - madre (informal) - hiragana
うつくしい - utsukushii - hermoso, bello - hiragana
ひと - hito - persona, personas - hiragana
コーヒー - koohii - café (anglicismo) - katakana
あかるい - akarui - luminoso, alegre, risueño - hiragana
てんいん - tenin - empleado (tienda) - hiragana
やきゅう - yakyuu - béisbol - hiragana
たのしい - tanoshii - divertido - hiragana
スポツ - supootsu - deporte (anglicismo) - katakana
そこ - soko - ahí, ese lugar - hiragana
ひろい - hiroi - espacioso, amplio - hiragana
みせ - mise - tienda, comercio, establecimiento - hiragana
ビル - biru - edificio (anglicismo), factura (anglicismo) - katakana
いい - ii - bueno, excelente, agradable - hiragana
てんき - tenki - clima, elementos de la naturaleza - hiragana
にもつ - nimotsu - equipaje - hiragana
かるい - karui - liviano, ligero, sin esfuerzo, - hiragana
スーツケース - suutsukeesu - maleta (anglicismo) - katakana
ねこ - neko - gato, carretilla, calentador de cama de arcilla - hiragana
かわいい - kawaii - bonito, hermoso, encantador - hiragana
どうぶつ - doubutsu - animal - hiragana
ちち - chichi - padre - hiragana
かしゅ - kasha - cantante - hiragana
まじめ - majime - diligente, serio, honesto - hiragana
たいせつ - taisetsu - importante, valioso, digno de cuidado - hiragana
かんたん - kantan - simple, sencillo - hiragana
もんだい - mondai - problema, pregunta - hiragana
あんぜん - anzen - seguro; seguridad - hiragana
くに - kuni - país - hiragana
すてき - suteki - encantador, maravilloso, espléndido - hiragana
こうえん - kouen - parque - hiragana
スーパー - suupaa - super (anglicismo), supermercado - katakana
べんり - benri - conveniente, útil - hiragana
そと - soto - exterior, al aire libre - hiragana
くらい - kurai - sombrío, oscuro, desconocido - hiragana
まんが - manga - comic, historieta, caricatura - hiragana
おもしろい - omoshiroi - interesante, entretenido - hiragana
おんがく - ongaku - música, movimiento musical - hiragana
ふゆ - fuyu - invierno - hiragana
さむい - samui - frío (clima) - hiragana
うみ - umi - mar, playa - hiragana
アイス - aisu - hielo (anglicismo), helado - katakana
つめたい - tsumetai - frío, gélido, congelado, antipático - hiragana
あかちゃん - akachan - bebé - hiragana
かっこいい - kakkoii - atractivo, guapo, elegante - hiragana
べんきょう - benkyou - estudio, diligencia, descuento - hiragana
ねむい - nemui - soñoliento, amodorrado - hiragana
しんぱい - shinpai - preocupación, preocupar - hiragana
ふくざつ - fukuzatsu - complejidad, complicación - hiragana
クリスマス - kurisumasu - Navidad (anglicismo) - katakana
にぎやか - nigiyaka - tumultuoso, ocupado - hiragana
だめ - dame - inútil, no es bueno, sin esperanza - hiragana
しごと - shigoto - trabajo, empleo, ocupación - hiragana
えき - eki - estación (estructura) - hiragana
ばか - baka - tonto, estúpido, idiota - hiragana
らく - raku - comodidad, alivio, paz, sin dificultades - hiragana
けち - kechi - avaricia, tacañería, avaro, cutre - hiragana
ひ - hi - día, sol - hiragana
しずか - shizuka - callado, silencioso, sin prisas - hiragana
まち - machi - pueblo, calle, camino - hiragana
わたしたち - watashitachi - nosotros - hiragana
なかがいい - nakagaii - próximo, íntimo, tener buena relación con - hiragana
パン - pan - pan - katakana
やわらかい - yawarakai - blando, tierno, flexible, maleable - hiragana
わかい - wakai - joven - hiragana
おちゃ - ocha - té (verde) - hiragana
あまい - amai - dulce, suave, indulgente, soso, poco salado - hiragana
かみ - kami - pelo (de cabeza), cabello - hiragana
ながい - nagai - largo, mucho tiempo, prolongado - hiragana
わるい - warui - malo, pobre, inferior, no rentable - hiragana
パソコン - pasokon - ordenador (anglicismo), computadora - katakana
あたらしい - atarashii - nuevo - hiragana
こわい - kowai - asustadizo, temeroso, espeluznante, espantoso - hiragana
えいが - eiga - cine, película - hiragana
うれしい - ureshii - feliz, alegre, agradable - hiragana
はなし - hanashi - habla, conversación, relato - hiragana
きびしい - kibishii - severo, estricto, implacable, difícil - hiragana
よわい - yowai - débil, delicado, inexperto, suave (alimento) - hiragana
サラダ - sarada - ensalada (anglicismo) - katakana
あつい - atsui - caliente (objeto) - hiragana
たべもの - tabemono - comida - hiragana
おおい - ooi - muchos, numeroso - hiragana
おもい - omoi - pesado, grave, serio - hiragana
むすめ - musume - (mi) hija; chica (i.e. una mujer joven y sin casar) - hiragana
せがたかい - segatakai - alto de estatura - hiragana
つよい - tsuyoi - fuerte, poderoso, vigoroso, valiente - hiragana
おとこ - otoko - hombre, varón - hiragana
つまらない - tsumaranai - aburrido, tedioso, insignificante - hiragana
ふかい - fukai - profundo - hiragana
かわ - kawa - río, arroyo, riachuelo - hiragana
あたまがいい - atamagaii - inteligente, brillante - hiragana
かなしい - kanashii - triste, dolor, duelo, pena - hiragana
さびしい - sabishii - solo, solitario, aislado, desolado - hiragana
ただしい - tadashii - correcto, justo, derecho - hiragana
がっこう - gakkou - escuela - hiragana
こ - ko - hijo, hija, niño, niña, acciones nuevas (bolsa), huevo de ave - hiragana
じょうず - jouzu - habilidoso, competente, bueno (en), inteligente - hiragana
え - e - pintura, dibujo, ilustración, cuadro, pintura - hiragana
パスタ - pasuta - pasta (extranjerismo) - katakana
よる - yoru - noche, cena - hiragana
むすこ - musuko - hijo (varón) - hiragana
みず - mizu - agua (fría, fresca) - hiragana
あおい - aoi - azul, verde, pálido, inmaduro - hiragana
たいへん - taihen - muy, inmenso, enorme, grave, espantoso - hiragana
ちかい - chikai - cerca - hiragana
こども - kodomo - niño, niños - hiragana
すき - suki - gustar, gustado - hiragana
はな - hana - flor, flor, pétalo - hiragana
さかな - sakana - pez, pescado - hiragana
ネクタイ - nekutai - corbata (extranjerismo) - katakana
きらい - kirai - disgusto, odio, sospecha, tendencia, indicio - hiragana
カラオケ - karaoke - karaoke (cantar música grabada) - katakana
おさけ - osake - sake - hiragana
びょういん - byouin - hospital - hiragana
ゴルフ - gorufu - golf (extranjerismo) - katakana
きもの - kimono - kimono, vestimenta tradicional japonesa (espec. de cuerpo entero), ropa - hiragana
えいご - eigo - Idioma Inglés - hiragana
めがね - megane - gafas, lentes - hiragana
ほしい - hoshii - deseado, deseado por, necesidad de - hiragana
イヤリング - iyaringu - pendiente (extranjerismo) - katakana
ジュース - juusu - jugo , zumo (extranjerismo) - katakana
じてんしゃ - jitensha - bicicleta - hiragana
エアコン - eakon - aire acondicionado - katakana
シャーペン - shaapen - portaminas - katakana
ビール - biiru - cerveza (extranjerismo) - katakana
ごはん - gohan - arroz (cocinado), platillo, comida - hiragana
ピアノ - piano - piano (eng:) - katakana
コート - kooto - abrigo (extranjerismo), campo deportivo - katakana
しゅふ - shufu - ama de casa, señora - hiragana
あさごはん - asagohan - desayuno - hiragana
しろい - shiroi - blanco - hiragana
タイ - tai - corbata, Tai, Tailandia - katakana
のみもの - nomimono - bebida - hiragana
おべんとう - obentou - o-bento, almuerzo portátil - hiragana
あたたかい - atatakai - cálido, afable, cordial, apacible, templado - hiragana
おにぎり - onigiri - bola de arroz (a menudo triangular, a veces con un relleno y envuelto en nori) - hiragana
おねえさん - oneechan - hermana mayor, (vocativo) jovencita, señora , madre (usado por las geishas para referirse a sus superioras) - hiragana
ばんごはん - bangohan - cena - hiragana
すきやき - sukiyaki - guiso tradicional a base de carne y verduras - hiragana
ですか - desuka - Al final de las frases, indica pregunta - hiragana
ジャケット - jaketto - chaqueta (extranjerismo), cubierta de libro, carátula de CD - katakana
くろい - kuroi - negro, oscuro - hiragana
いろ - iro - color, sensualidad, lujuria - hiragana
ぎんこういん - ginkouin - empleado de banca, banquero - hiragana
てんぷら - tenpura - "tempura": fritura de mariscos y vegetales rebozados - hiragana
ことし - kotoshi - este año - hiragana
なん - nan - qué - hiragana
ワイン - wain - vino (extranjerismo) - katakana
ばしょ - basho - lugar, ubicación - hiragana
ゆうびんきょく - yuubinkyoku - oficina postal, oficina de correos - hiragana
おおきな - ookina - grande, gran, largo - hiragana
ケーキや - keekiya - pastelería - hiragana
どこ - goto - dónde, en qué lugar - hiragana
おとうさん - otousan - padre - hiragana
だれ - dare - quién - hiragana
じょせい - josei - sexo femenino, mujer (mejor término que onna) - hiragana
せのたかい - senotakai - Alto (de una persona) - hiragana
だんせい - dansei - sexo masculino, hombre - hiragana
おにいさん - oniichan - hermano mayor, (vocativo) joven, chico, hermano mayor, (vocativo) ¿Señor? - hiragana
どんな - donna - como qué, qué tipo de - hiragana
もくようび - mokuyoubi - jueves - hiragana
げつようび - getsuyoubi - lunes - hiragana
すいようび - suiyoubi - miércoles - hiragana
ケーキ - keeki - pastel - katakana
うた - uta - canción; poesía clásica japonesa, poema - hiragana
とり - tori - pájaro, ave, corral - hiragana
からい - karai - picante; salado; persona dura, adverso, desfavorable, áspero, cruel - hiragana
シャツ - shatsu -  camisa - katakana
あかい - akai -  rojo; comunista - hiragana
ドレス - doresu - vestido - katakana
スカート - sukaato - falda - katakana
いたい - itai - doloroso, me duele - hiragana
ところ - tokoro - lugar, escenario [lugar general e incluso metafórico], dirección, área, localidad - hiragana
わたし - watashi - yo - hiragana
はなす - hanasu - hablar - hiragana
あに - ani - hermano mayor - hiragana
かす - kasu - prestar; alquilar - hiragana
かう - kau - comprar - hiragana
あう - au - conocerse, encontrarse con, tener un accidente/mala experiencia, afrontar - hiragana
しゃちょう - shachou - presidente de la compañía, gerente, director - hiragana
きく - kiku - oír, escuchar, preguntar - hiragana
かく - kaku - escribir - hiragana
かえる - kaeru - volver a casa, regresar, (un invitado, cliente, etc.) irse - hiragana
とる - toru - coger, tomar, cosechar, ganar - hiragana
あね - ane - hermana mayor - hiragana
しぬ - shinu - morir - hiragana
たつ - tatsu - estar/ponerse de pie; encontrarse en problemas, partir (en tren, avión, etc) - hiragana
まつ - matsu - esperar en, esperar de, tener la esperanza puesta en, tener expectativas de, contar con - hiragana
よぶ - yobu - llamar, vocear, llamar a gritos - hiragana
あそぶ - asobu - jugar, hacer una visita; estar ocioso - hiragana
いもうと - imouto - hermana menor - hiragana
よむ - yomu - leer - hiragana
のむ - nomu - beber, tragar, ingerir, fumar, devorar, aceptar (ej. Demanda, condición), ocultar - hiragana
おとうと - otouto - hermano menor - hiragana
およぐ - oyogu - nadar - hiragana
いそぐ - isogu - apresurar, apurar - hiragana
する - suru - hacer, intentar, ejecutar, jugar, practicar - hiragana
くる - kuru - llegar, venir - hiragana
しょくじする - shokujisuru - Comer, cenar - hiragana
はたらく - hataraku - trabajar, funcionar, actuar, ser efectivo, cometer, perpetrar - hiragana
うたう - utau - cantar - hiragana
おしえる - oshieru - enseñar, informar, instruir - hiragana
きょうしつ - kyoushitsu - aula, clase - hiragana
べんきょうする - benkyousuru - estudiar - hiragana
きょうかい - kyoukai - iglesia - hiragana
けっこんする - kekkonsuru - casarse, contraer matrimonio - hiragana
たいいくかん - taiikukan - gimnasio - hiragana
れんしゅうする - ranshuusuru - practicar - hiragana
ぎんこう - ginkou - banco - hiragana
つとめる - tsutomeru - desempeñar, ejercer, hacerse cargo de, trabajar, servir, estar empleado - hiragana
レストラン - resutoran - restaurante - katakana
たべる - taberu - comer - hiragana
きっさてん - kissaten - cafetería - hiragana
どうぶつえん - doubutsuen - zoológico - hiragana
かれら - karera - ellos - hiragana
プール - puuru - piscina - katakana
ごじ - goji - Cinco en punto (hora) - hiragana
おきる - okiru - levantarse, despertarse; suceder, tener lugar - hiragana
はちじ - hachiji - Ocho en punto (hora) - hiragana
ねる - neru - acostarse, dormir - hiragana
しちじ - shichiji - 7 en punto (hora) - hiragana
でかける - dekakeru - partir, salir fuera, ponerse en marcha - hiragana
じゅうにじ - juuniji - doce en punto (hora) - hiragana
つく - tsuku - llegar a, alcanzar; formar parte de, sentarse a - hiragana
じゅういちじ - juuichiji - once en punto - hiragana
こどもたち - kodomotachi - niños (grupo) - hiragana
ろくじ - rokuji - 6 en punto (hora) - hiragana
おなかがすく - onakagasuku - tener hambre - hiragana
しがつ - shigatsu - abril - hiragana
はじまる - hajimaru - comenzar - hiragana
としょかん - toshokan - biblioteca - hiragana
ひらく - hiraku - abrirse, quedarse abierto, quedarse vacío - hiragana
じゅうにがつ - juunigatsu - diciembre - hiragana
しちがつ - shichigatsu - julio - hiragana
おくる  - okuru - enviar (cosas), despachar, escoltar, acompañar, despedirse - hiragana
コンサート - konsaato - concierto - katakana
ふく - fuku - ropa (esp. ropa occidental); contador para dosis (medicina, tragos, caladas...) - hiragana
つくる - tsukuru - hacer, crear, fabricar, manufacturar, etc... - hiragana
うる - uru - vender - hiragana
まんねんひつ - mannenhitsu - pluma estilográfica - hiragana
つかう - tsukau - despachar, enviar, donar, usar, manipular, emplear, necesitar, querer... - hiragana
さしみ - sashimi - Sashimi (Pescado cortado en rajas) - hiragana
ダンス - dansu - danza - hiragana
おどる - odoru -bailar, danzar; saltar - hiragana
いけばな - Ikebana - Ikebana (arte de arreglo floral) - hiragana
ノート - nooto - libreta, cuaderno - katakana
みせる - miseru - mostrar - hiragana
おさら - osara - plato, platillo - hiragana
あらう - arau - lavar - hiragana
しゃしん - shashin - fotografía - hiragana
とる - toru - grabar (vídeo, audio, etc.), tomar (foto), hacer (película) - hiragana
そふ - sofu - abuelo (propio) - hiragana
タバコ - tabako - tabaco, cigarrillos, puros; planta de tabaco - katakana
すう - suu - fumar, aspirar, inhalar; chupar, sorber; absorber, embeber; besar - hiragana
しんぶん - sinbun - periódico - hiragana
アパート - apaato - apartamento, bloque de apartamentos - katakana
かりる - kariru - tomar prestado, rentar, alquilar - hiragana
きる - kiru - vestir, ponerse, llevar puesto; cargar con (culpa, etc.) - hiragana
そぼ - sobo - abuela - hiragana
アメリカ - amerika - América - katakana
くうこう - kuukou - aeropuerto - hiragana
いく - iku - ir, moverse (hacia), dirigirse (hacia); atravesar, pasar por - hiragana
がいこく - gaikoku - país extranjero - hiragana
おんせん - onsen - aguas termales, balneario, spa - hiragana
けっこんしき - kekkonshiki - ceremonia de matrimonio, boda - hiragana
たいしかん - taishikan - embajada - hiragana
デパート - depaato - centro comercial, grandes almacenes - hiragana
かぞく - kazoku - familia, familiares - hiragana
イギリス - igirisu - Gran Bretaña, Reino Unido - hiragana
りょかん - ryokan - hostal (estilo japonés) - hiragana
ホテル - hoteru - hotel - hiragana
いなか - inaka - rural, el campo, suburbio; ciudad de origen o residencia - hiragana
やすむ - yasumu - descansar, tener un respiro, tomarse el día - hiragana
すわる - suwaru - sentarse, ponerse en cuclillas; asumir posición - hiragana
せいと - seito - alumno (generalmente de primaria/instituto) - hiragana
フランスご - furansugo -  francés (idioma) - hiragana
ようふく - youfuku - ropa estilo occidental - hiragana
クラブ - kurabu - club, sede de un club - hiragana
てつだう - tetsudau - ayudar, tomar parte en - hiragana
あるく - aruku - caminar - hiragana
たまご - tamago - huevo; experto en preparación, futuro experto - hiragana
やま - yama - montaña; montón; climax - hiragana
あさ - asa - mañana (momento del día); desayuno - hiragana
でんしゃ - densha - tren eléctrico - hiragana
のる - noru - subirse, entrar (a vehículo); extender (pantalones) - hiragana
ひこうき - hikouki - avión - hiragana
わらう - warau - reír, sonreír; burlarse de - hiragana
チョコレート - chokoreeto - chocolate - hiragana
やさい - yasau - verdura - hiragana
サッカー - sakkaa - fútbol - katakana
ぎゅうにゅう - gyuunyuu - leche de vaca - hiragana