kya - キャ
kyu - キュ
kyo - キョ
gya - ギャ
gyu - ギュ
gyo - ギョ
sha - シャ
shu - シュ
sho - ショ
ja - ジャ
ju - ジュ
jo - ジョ
cha - チャ
chu - チュ
cho - チョ
nya - ニャ
nyu - ニュ
nyo - ニョ
hya - ヒャ
hyu - ヒュ
hyo - ヒョ
bya - ビャ
byu - ビュ
byo - ビョ
pya - ピャ
pyu - ピュ
pyo - ピョ
mya - ミャ
myu - ミュ
myo - ミョ
rya - リャ
ryu - リュ
ryo - リョ
chi - チ
tsu - ツ
dzu - ヅ
shi - シ
ka - カ
ki - キ
ku - ク
ke - ケ
ko - コ
sa - サ
su - ス
se - セ
so - ソ
ta - タ
te - テ
to - ト
na - ナ
ni - ニ
nu - ヌ
ne - ネ
no - ノ
ha - ハ
hi - ヒ
fu - フ
he - ヘ
ho - ホ
ma - マ
mi - ミ
mu - ム
me - メ
mo - モ
ya - ヤ
yu - ユ
yo - ヨ
ra - ラ
ri - リ
ru - ル
re - レ
ro - ロ
wa - ワ
wo - ヲ
n - ン
ga - ガ
gi - ギ
gu - グ
ge - ゲ
go - ゴ
za - ザ
ji - ジ
zu - ズ
ze - ゼ
zo - ゾ
da - ダ
di - ヂ
du - ヅ
de - デ
do - ド
ba - バ
bi - ビ
bu - ブ
be - ベ
bo - ボ
pa - パ
pi - ピ
pu - プ
pe - ペ
po - ポ
a - ア
i - イ
u - ウ
e - エ
o - オ
bonpu - ー